13
N A - - N N -
- - A D D - -
D - A N N A D
N N A - A A A
N - - N - - N
N A N A - - -
A A A N - - A
A N N A A - -
A - N A N - -
D D D N N - -
A A A - A A D
- N N N - - -
D D N A - A A
- A N - - - A
A A - - - A N
A A D - N - -
A N A - N N -
N N N D D D -
- A A D D D A
- - A - A N -
D N - A A N N
A A N N N - N
N - - A N A -
N - A N A - -
- D D N N - -
A N N A A - -
N N N N - - A
N N - A A - -
N N A A A - -
A A - N N - -
